44 44
11111111111111111111111111111111111111111111
10000000000000000000000000000000000000000001
11101101111111111111111111110101101011010101
10110101000101010101010100011110111010111101
10100111111011101110111011100101100111100001
10111101010101010001010110010010111101011101
10100110001110110111101011111111101011110101
10110101010011101010011110100100110101011001
10101111111110111111110101000010101101101101
10010010010001000010100011100110110110011001
10111110101111111100000100111100011010101101
10100011111001010110101111100110101111101001
10011110100100101101110100111011110001011101
10110011011111110111010110010110010100101001
10001101110100001001001101001101101111110001
10110101001111111000110101110110111010101001
10101111010000010101010101001001101101011101
10111001111111011111111111111110110101010001
10101011010101010100100101010101101011111101
10010101100101101111011110110111011101010001
10111111011011010101100101010101110111001101
10010001110101110110110111001001011001110101
10101111011100011011001101101110101101011101
10111010101011010100100110111011101011010101
10010111100001111110111001001100110101010101
10101010111011010011101111011011011110111001
10111110100101010101010101101101110101101101
10010101111101010111111011010010101010110101
10001101001001100010010100111111011010000101
10000110111110010111011111101010101111111001
10001101010101011101010101011001111010101001
10010111010111101010111011101111010101101101
10111101101100110111010101011010111110110101
10101010000110101010111110110011010010101101
10001111101100101011010001100110111101110101
10111010110101111110111110111011010010011001
10101011010110010011010101101101010111001101
10101000011000011101101000100110111100100101
10011111101110110110111001011011010011110101
10110100100101100001101111110010111110101001
10010011110110110110101001011101010101001001
10111010101100011101101011100111101111111111
10000000000000000000000000000000000000000001
11111111111111111111111111111111111111111111
2 2 41 42
